gl3d=gl3D
bgcolor=bgColor
familysrc=familySrc
sizesrc=sizeSrc
colorsrc=colorSrc
bgcolorsrc=bgColorSrc
bordercolorsrc=borderColorSrc
alignsrc=alignSrc
namelengthsrc=nameLengthSrc
hv=hv
vh=vh
hvh=hvh
vhv=vhv
tozeroy=toZeroY
tozerox=toZeroX
tonexty=toNextY
tonextx=toNextX
ew=ew
autocolorscale=autoColorScale
widthsrc=widthSrc
typesrc=typeSrc
lenmode=lenMode
tickvals=tickVals
showticklabels=showTickLabels
showtickprefix=showTickPrefix
showticksuffix=showTickSuffix
tickvalssrc=TickValsSrc
ticktextsrc=tickTextSrc
symbolsrc=symbolSrc
opacitysrc=opacitySrc
tracerefminus=traceRefMinus
arraysrc=arraySrc
arrayminussrc=arrayMinusSrc
nanakshahi=nanakshahi
jalali=jalali
ummalqura=ummalqura
insidetextanchor=insideTextAnchor
outliers=outliers
suspectedoutliers=suspectedOutliers
quartilemethod=quartileMethod
outliercolor=outlierColor
outlierwidth=outlierWidth
histfunc=histFunc
histogram2d=histogram2D
histogram2dcontour=histogram2DContour
kde=kde
rgb=rgb
rgba=rgba
hsl=hsl
hsla=hsla
colorssrc=ColorsSrc
insidetextorientation=insideTextOrientation
squarify=squarify
squarifyratio=squarifyRatio
scatter3d=scatter3D
longdashdot=longDashDot
usecolormap=useColorMap
specular=specular
isosurface=isoSurface
locationssrc=locationsSrc
vertexnormalsepsilon=vertexNormalsEpsilon
facenormalsepsilon=faceNormalsEpsilon
mesh3d=mesh3D
delaunayaxis=delaunaYAxis
xsrc=xSrc
ysrc=ySrc
zsrc=zSrc
scattergeo=scatterGeo
geojson=geoJson
choropleth=choropleth
scattergl=scatterGl
splom=splom
heatmapgl=heatMapGl
parcoords=parCoords
scattermapbox=scatterMapBox
anglesrc=angleSrc
choroplethmapbox=choroplethMapBox
densitymapbox=densityMapBox
sankey=sankey
labelsrc=labelSrc
customdatasrc=customDataSrc
hovertemplatesrc=hoverTemplateSrc
sourcesrc=sourceSrc
targetsrc=targetSrc
valuesrc=valueSrc
minorgridcount=minorGridCount
minorgridwidth=minorGridWidth
minorgridcolor=minorGridColor
startlinecolor=startLineColor
startlinewidth=startLineWidth
endlinewidth=endlineWidth
endlinecolor=endlineColor
arraytick0=arrayTick0
arraydtick=arrayDTick
categoryarraysrc=categoryArraySrc
ohlc=ohlc
radians=radians
gradians=gradians
scatterpolargl=scatterPolarGl
/^x([2-9]|[1-9][0-9]+)?$/=XRegex
/^y([2-9]|[1-9][0-9]+)?$/=YRegex
modebar=modeBar
drawclosedpath=drawClosedPath
drawopenpath=drawOpenPath
drawrect=drawRect
groupssrc=groupsSrc
multicategory=multiCategory
unselected=unselected
insidetextfont=insideTextFont
outsidetextfont=outsideTextFont
equirectangular=equiRectangular
kavrayskiy7=kavrayskiy7
eckert4=eckert4
azimuthal=azimuthal
gnomonic=gnomonic
mollweide=mollweide
albers=albers
winkel=winkel
aitoff=aitoff
lonaxis=lonAxis
itemdoubleclick=itemDoubleClick
stddev=stdDev
funcmode=funcMode
func=func
uirevision=uiRevision
tickformatstop=tickFormatStop
dtickrange=dTickRange
templateitemname=templateItemName
tickformatstops=tickFormatStops
zerolinecolor=zeroLineColor
zerolinewidth=zeroLineWidth
showaxeslabels=showAxesLabels
ay=ay
startarrowsize=startArrowSize
showsubunits=showSubUnits
subunitcolor=subUnitColor
subunitwidth=subUnitWidth
dashsrc=dashSrc
tracegroupgap=traceGroupGap
ayref=ayRef
clicktoshow=clickToShow
xsizemode=xSizeMode
ysizemode=ySizeMode
x0=x0
x1=x1
y0=y0
y1=y1
args=args
args2=args2
activebgcolor=activeBgColor
minorticklen=minorTickLen
valuessrc=valuesSrc
multiselect=multiSelect
formatsrc=formatSrc
prefixsrc=prefixSrc
suffixsrc=suffixSrc
metasrc=metaSrc
dx=dX
cliponaxis=clipOnAxis
idssrc=idsSrc
hoverinfosrc=hoverInfoSrc
textsrc=textSrc
texttemplatesrc=textTemplateSrc
hovertextsrc=hoverTextSrc
textpositionsrc=textPositionSrc
rsrc=rSrc
tsrc=tSrc
basesrc=baseSrc
offsetsrc=offsetSrc
q1=q1
q3=q3
jitter=jitter
pointpos=pointPos
q1src=q1Src
mediansrc=medianSrc
q3src=q3Src
lowerfencesrc=lowerFenceSrc
upperfencesrc=upperFenceSrc
notchspansrc=notchSpanSrc
meansrc=meanSrc
sdsrc=sdSrc
hoverongaps=hoverOnGaps
zhoverformat=zHoverFormat
nbinsx=nBinsX
nbinsy=nBinsY
autobinx=autoBinX
autobiny=autoBinY
xbingroup=xBinGroup
ybingroup=yBinGroup
asrc=aSrc
bsrc=bSrc
csrc=cSrc
measuresrc=measureSrc
labelssrc=labelsSrc
pullsrc=pullSrc
parentssrc=parentsSrc
surfacecolorsrc=surfaceColorSrc
isomin=isoMin
isomax=isoMax
isrc=iSrc
jsrc=jSrc
ksrc=kSrc
intensitysrc=intensitySrc
vertexcolorsrc=vertexColorSrc
facecolorsrc=faceColorSrc
usrc=uSrc
vsrc=vSrc
wsrc=wSrc
featureidkey=featureIdKey
lonsrc=lonSrc
latsrc=latSrc
showupperhalf=showUpperHalf
showlowerhalf=showLowerHalf
xy=xY
xysrc=xYSrc
indicessrc=indicesSrc
xboundssrc=xBoundsSrc
yboundssrc=yBoundsSrc
countssrc=countsSrc
radiussrc=radiusSrc
columnwidthsrc=columnWidthSrc
columnordersrc=columnOrderSrc
a0=a0
b0=b0
opensrc=openSrc
highsrc=highSrc
lowsrc=lowSrc
closesrc=closeSrc
r0=r0
thetasrc=thetaSrc
bargroupgap=barGroupGap
boxgroupgap=boxGroupGap
violingroupgap=violinGroupGap
funnelgroupgap=funnelGroupGap
waterfallgroupgap=waterfallGroupGap
extendpiecolors=extendPieColors
hiddenlabelssrc=hiddenLabelsSrc
extendsunburstcolors=extendSunburstColors
treemapcolorway=treeMapColorway
extendtreemapcolors=extendTreeMapColors
funnelareacolorway=funnelAreaColorway
extendfunnelareacolors=extendFunnelAreaColors
rect=rect
xref=xRef
topojsonURL=topoJsonUrl
plotlyServerURL=plotlyServerUrl
ticklen=tickLen
ticklabelmode=tickLabelMode
xperiodalignment=xPeriodAlignment
yperiodalignment=yPeriodAlignment
xperiod0=xPeriod0
yperiod0=yPeriod0
rgba256=rgba256
autotypenumbers=autoTypeNumbers
ticklabelposition=tickLabelPosition
ticklabeloverflow=tickLabelOverflow
xhoverformat=xHoverFormat
yhoverformat=yHoverFormat
fgcolor=fgColor
fgopacity=fgOpacity
shapesrc=shapeSrc
fgcolorsrc=fgColorSrc
soliditysrc=soliditySrc
uhoverformat=uHoverFormat
vhoverformat=vHoverFormat
whoverformat=wHoverFormat
valuehoverformat=valueHoverFormat
parcats=parCats
addsrc=addSrc
removesrc=removeSrc
extendiciclecolors=extendIcicleColors
categoryorder=categoryOrder
xanchor=xAnchor
hoverlabel=hoverLabel
colorbar=colorBar
legendgrouptitle=legendGroupTitle
bertin1953=bertin1953
bonne=bonne
bottomley=bottomley
bromley=bromley
collignon=collignon
eckert1=eckert1
eckert2=eckert2
eckert3=eckert3
eckert5=eckert5
eckert6=eckert6
eisenlohr=eisenlohr
foucaut=foucaut
ginzburg4=ginzburg4
ginzburg5=ginzburg5
ginzburg6=ginzburg6
ginzburg8=ginzburg8
ginzburg9=ginzburg9
gringorten=gringorten
quincuncial=quincuncial
guyou=guyou
homolosine=homolosine
hufnagel=hufnagel
larrivee=larrivee
laskowski=laskowski
loximuthal=loximuthal
quartic=quartic
nicolosi=nicolosi
peirce=peirce
sinu=sinu
grinten2=grinten2
grinten3=grinten3
grinten4=grinten4
wagner4=wagner4
wagner6=wagner6
wiechel=wiechel
winkel3=winkel3
ticklabelstep=tickLabelStep
grouptitlefont=groupTitleFont
imagsrc=imagSrc
realsrc=realSrc
imag=imag
